111111111
1001C10E1
1P0010001
111111111
