1111111111111111111111111111111111
1EC000000000000C00000C000000000001
1010010100100000101001000000010101
1010010010101011111101000000010101
1P0000000C00C0100001000000000001C1
1111111111111111111111111111111111
