11111111111111
1EC00000000001
10100101010101
10100100010101
1P00C00C0001C1
11111111111111
